wwwwwww
w  c  w
w  w  w
ww w ww
w b B w
wwg   w
wwwwwww