wwwwwww 
w  c  ww
w  w   w
ww w w w
w b B  w
wwg    w
w      w
w      w
wwwwwwww