wwwww 
w c  w
w b  w
w w  w
ww   w
wg   w
wwwww 