wwwwwwww
w  c  ww
w  w  ww
ww w www
w b B  w
wwg    w
w      w
w      w
wwwwwwww