      wwwww
      wg  w
      wgw w
wwwwwwwgw w
w c b b b w
w w w w www
w       w  
wwwwwwwww  